''''''''''''''''''''''''''''''''''''''''''''''''''''''''''''''''''''''''''''''''/
################################################################################/
#''''''''''''''''''''''''''''''''''''''''''''''''''''''''''''''''''''''''''''''#/
#'%''''$''''''''''''''''''''''''''''''''''''''''''''$''''''''''''''''$'''''''%'#/
#''''''''''''''''''''''''''''''''''''''%'''''''''''''''''''''''''''''''''''''''#/
#''''''''''''''''''''''''''''''''''''''''''''''''''''''''''''''''''''''''''''''#/
#''''''''''''''''''''''''''''''''''''''''''''''''''''''''''''''''''''''''''''''#/
#''$'''''''''''''''%'####''''$''''''''''''''''''''''''####'%'''''''''''''''''''#/
#'''''''''''''''''''''''#####'''''''''''''''''''''#####''''''''''''''''''''''''#/
#'''''''''''''''''''''''#'''###########'###########'''#''''''''''''''''''''''''#/
#'''''''''''''''''''''''#''''''''''''''''''''''''''$''#''''''''''''''''''''''''#/
#'''''''''''$'''''''''''#'''''''''''''''''''''''''''''#''''''''''''''''''''''''#/
#'''''''''''''''''''''''#''''''''''''''@''''''''''''''#''''''''''''$'''''''''''#/
#'''''''''''''''''''''''#'''''''''''''''''''''''''''''#''''''''''''''''''''''''#/
#'''''''''''''''''''''''###############################''''''''''''''''''''''''#/
#''''''''''''''''''''''''''''''''''''''''''''''''''''''''''''''''''''''''''''''#/
#''''''''''''''''''''''''''''''''''''''''''''''$'''''''''''''''''''''''''''''''#/
#'''''$''''''''''''''''''''''''''''''''''''''''''''''''''''''''''''''''''''''''#/
#''''''''''''''''''%'''''''''$'''''''''''''''''''''''''''''%'''''''''''''''''''#/
#''''''''''''''''''''''''''''''''''''''''''''''''''''''''''''''''''''''''''''''#/
#''''''''''''''''''''''''''''''''''''''''''''''''''''''''''''''''''''''''''''''#/
#'''''''''''''''''''''''''''''''''''''''''''''''''''''''''''''''''''''$''''''''#/
#'%'''''''''$''''''''''''''''''''''''''%'''''''''''''''''''''''''''''''''''''%'#/
#''''''''''''''''''''''''''''''''''''''''''''''''''''''''''''''''''''''''''''''#/
################################################################################/
