''''''''''''''''''''''''''''''''''Battlefield'''''''''''''''''''''''''''''''''''/
################################################################################/
#''''''''''''''''''''''''''''''''''''''''''''''''''''''''''''''''''''''''''''''#/
#''''''''''''''''''''''''''''''''''''''''''''''''''''''''''''''''''''''''''''''#/
#''''''''''''''''''''''''''''''''''''''''''''''''''''''''''''''''''''''''''''''#/
#''''''''''''''''''''''''''''''''''''''''''''''''''''''''''''''''''''''''''''''#/
#''''''''''''''''''''''''''''''''''''''''''''''''''''''''''''''''''''''''''''''#/
#''''''''''''''''''''''''''''''''''''''''''''''''''''''''''''''''''''''''''''''#/
#''''''''''''''''''''''''''''''''''''''''''''''''''''''''''''''''''''''''''''''#/
#''''''''''''''''''''''''''''''''''''''''''''''''''''''''''''''''''''''''''''''#/
#''''''''''''''''''''''''''''''''''''''''''''''''''''''''''''''''''''''''''''''#/
#''''''''''''''''''''''''''''''''''''''''''''''''''''''''''''''''''''''''''''''#/
#''''''''''''''''''''''''''''''''''''''@'''''''''''''''''''''''''''''''''''''''#/
#''''''''''''''''''''''''''''''''''''''''''''''''''''''''''''''''''''''''''''''#/
#''''''''''''''''''''''''''''''''''''''''''''''''''''''''''''''''''''''''''''''#/
#''''''''''''''''''''''''''''''''''''''''''''''''''''''''''''''''''''''''''''''#/
#''''''''''''''''''''''''''''''''''''''''''''''''''''''''''''''''''''''''''''''#/
#''''''''''''''''''''''''''''''''''''''''''''''''''''''''''''''''''''''''''''''#/
#''''''''''''''''''''''''''''''''''''''''''''''''''''''''''''''''''''''''''''''#/
#''''''''''''''''''''''''''''''''''''''''''''''''''''''''''''''''''''''''''''''#/
#''''''''''''''''''''''''''''''''''''''''''''''''''''''''''''''''''''''''''''''#/
#''''''''''''''''''''''''''''''''''''''''''''''''''''''''''''''''''''''''''''''#/
#''''''''''''''''''''''''''''''''''''''''''''''''''''''''''''''''''''''''''''''#/
#''''''''''''''''''''''''''''''''''''''''''''''''''''''''''''''''''''''''''''''#/
################################################################################/
