''''''''''''''''''''''''''''''''''''''''''''''''''''''''''''''''''''''''''''''''/
################################################################################/
#''''''''''''''''''''''''''''''''''''''''''''''''''''''''''''''''''''''''''''''#/
#''''''''''''''''''''''''''''''''''''''''''''''''''''''''''''''''''''''''''''''#/
#''''''''''''''''''''''''''''''''''''''''''''''''''''''''''''''''''''''''''''''#/
#''''''''''''''''''''''''''''''''''''''''''''''''''''''''''''''''''''''''''''''#/
#'''''''''''''''''''''''Are'you'listening?'its'all!''''''''''''''''''''''''''''#/
#''''''''''''''''''''''''''''''''''''''''''''''''''''''''''''''''''''''''''''''#/
#''''''''''''''''''''''''''''''''''''''''''''''''''''''''''''''''''''''''''''''#/
#''''''''''''''''''''''''''''''''''''''''''''''''''''''''''''''''''''''''''''''#/
<''''''''''''''''''''''''''''''''''''''''''''''''''''''''''''''''''''''''''''''>/
#''''''''''''''''''''''''''''''''''''''''''''''''''''''''''''''''''''''''''''''#/
#''''''''''''''''''''''''''''''''''''''''''''''''''''''''''''''''''''''''''''''#/
#''''''''''''''''''''''''''''''''''''''''''''''''''''''''''''''''''''''''''''''#/
#''''''''''''''''''''''''''''''''''''''''''''''''''''''''''''''''''''''''''''''#/
#''''''''''''''''''''''''''''''''''''''''''''''''''''''''''''''''''''''''''''''#/
#''''''''''''''''''''''''''''''''''''''''''''''''''''''''''''''''''''''''''''''#/
#''''''''''''''''''''''''''''''''''''''''''''''''''''''''''''''''''''''''''''''#/
#''''''''''''''''''''''''''''''''''''''''''''''''''''''''''''''''''''''''''''''#/
#''''''''''''''''''''''''''''''''''''''''''''''''''''''''''''''''''''''''''''''#/
#''''''''''''''''''''''''''''''''''''''''''''''''''''''''''''''''''''''''''''''#/
#''''''''''''''''''''''''''''''''''''''''''''''''''''''''''''''''''''''''''''''#/
#''''''''''''''''''''''''''''''''''''''''''''''''''''''''''''''''''''''''''''''#/
#''''''''''''''''''''''''''''''''''''''''''''''''''''''''''''''''''''''''''''''#/
################################################################################/
